1111111111111111
1000000000000001
10000000000C0001
1000000P00001111
1E00011101000001
1000011100000011
1111111111111111
